border_size=1
usage=map

Gg          , Gg          , Gs^Fp       , Gs^Fp       , Gg          , Gg          , Gs^Fp       , Hh          , Hh          , Gg          , Hh          , Hh          , Gs^Fp       , Gs^Fp       , Gs^Fp       , Gs^Fp       , Gs^Fp       , Gs^Fp       , Re          , Gg          , Re          , Re          
Gg          , Gg          , Gs^Fp       , Gs^Fp       , Gg          , Gg          , Gs^Fp       , Hh          , Hh          , Gg          , Hh^Vhh      , Hh          , Gs^Fp       , Gs^Fp       , Gs^Fp       , Gs^Fp       , Gs^Fp       , Gs^Fp       , Re          , Gg          , Re          , Re          
Gs^Fp       , Gs^Fp       , Gg          , Gs^Fp       , Gs^Fp       , Gs^Fp       , Mm          , Hh          , Gs^Fp       , Gs^Fp       , Gs^Fp       , Gs^Fp       , Gs^Fp       , Gs^Fp       , Gg          , Gg          , Re          , Re          , Gg          , Re          , Gs^Fp       , Gs^Fp       
Hh          , Hh          , Mm          , Mm          , Mm          , Mm          , Gs^Fp       , Mm          , Gs^Fp       , Gs^Fp       , Gs^Fp       , Gs^Fp       , Gg          , Gg          , Re          , Re          , Ce          , Ce          , Ce          , Gg          , Gs^Fp       , Gs^Fp       
Hh          , Hh          , Mm          , Gs^Fp       , Gs^Fp       , Gs^Fp       , Hh          , Gs^Fp       , Gs^Fp       , Gs^Fp       , Gg          , Gg          , Re          , Re          , Gs^Fp       , Gg          , Ce          , 2 Ke        , Ce          , Gg          , Gs^Fp       , Gs^Fp       
Hh          , Hh          , Hh          , Mm          , Hh^Vhh      , Gs^Fp       , Gs^Fp       , Gs^Fp       , Gg          , Gg          , Re          , Re          , Gg          , Gg          , Gs^Fp       , Gs^Fp       , Gs^Fp       , Ce          , Gs^Fp       , Gg          , Gs^Fp       , Gs^Fp       
Gs^Fp       , Gs^Fp       , Hh          , Gg          , Gs^Fp       , Gs^Fp       , Gs^Fp       , Gg          , Gs^Fp       , Gg^Vh       , Re          , Gg          , Gg          , Gs^Fp       , Gg          , Gs^Fp       , Gg          , Gs^Fp       , Gg          , Gg          , Hh          , Hh          
Gs^Fp       , Gs^Fp       , Gs^Fp       , Hh          , Gs^Fp       , Gs^Fp       , Gs^Fp       , Gs^Fp       , Gs^Fp       , Re          , Gg          , Gg          , Gg          , Gs^Fp       , Gs^Fp       , Gg          , Gs^Fp       , Gs^Fp       , Gs^Fp       , Hh^Vhh      , Hh          , Hh          
Gs^Fp       , Gs^Fp       , Gs^Fp       , Hh          , Gs^Fp       , Gs^Fp       , Hh          , Gs^Fp       , Gg          , Re          , Re          , Gg          , Gs^Fp       , Gg^Vh       , Gg          , Gs^Fp       , Gs^Fp       , Hh          , Gs^Fp       , Mm          , Mm          , Mm          
Gg          , Gg          , Hh^Vhh      , Gs^Fp       , Gs^Fp       , Gg          , Gg          , Hh          , Gs^Fp       , Gg          , Re          , Gg          , Gg          , Gs^Fp       , Gs^Fp       , Gg          , Gs^Fp       , Hh          , Gs^Fp       , Mm          , Mm          , Mm          
Gs^Fp       , Gs^Fp       , Hh          , Gs^Fp       , Mm          , Gs^Fp       , Gg          , Gg          , Hh          , Gg          , Gg          , Re          , Re          , Gg          , Gg          , Gs^Fp       , Gg          , Hh          , Hh          , Hh          , Hh          , Hh          
Gs^Fp       , Gs^Fp       , Gs^Fp       , Mm          , Mm          , Mm          , Mm          , Gg          , Gs^Fp       , Gg          , Gg          , Gg          , Gg          , Re          , Re          , Gg          , Gs^Fp       , Gs^Fp       , Gs^Fp       , Hh          , Gg          , Gg          
Hh          , Hh          , Gg          , Gg          , Gg          , Gg          , Hh^Vhh      , Mm          , Gs^Fp       , Hh          , Gs^Fp       , Gg          , Gg          , Gg          , Re          , Gg          , Gs^Fp       , Gs^Fp       , Gs^Fp       , Gs^Fp       , Gs^Fp       , Gs^Fp       
Gg          , Gg          , Re          , Gg          , Gg          , Gs^Fp       , Gs^Fp       , Gg          , Gg          , Gs^Fp       , Gs^Fp       , Gs^Fp       , Gg          , Re          , Gs^Fp       , Gg          , Gs^Fp       , Gs^Fp       , Gs^Fp       , Hh^Vhh      , Gs^Fp       , Gs^Fp       
Re          , Re          , Ce          , Re          , Re          , Gg          , Gg          , Gg          , Re          , Gg          , Gg          , Gs^Fp       , Gg          , Re          , Gs^Fp       , Gg          , Gs^Fp       , Gs^Fp       , Gs^Fp       , Hh          , Hh          , Hh          
Gg          , Gg          , 3 Ke        , Ce          , Gg          , Re          , Re          , Re          , Gg          , Re          , Re          , Gg          , Re          , Re          , Gg          , Gg          , Gs^Fp       , Gs^Fp       , Hh          , Mm          , Hh          , Hh          
Gs^Fp       , Gs^Fp       , Gg          , Gg          , Gg          , Gg          , Gs^Fp       , Gs^Fp       , Gg          , Gg          , Re          , Re          , Gg          , Gs^Fp       , Gg          , Gs^Fp       , Gg          , Mm          , Mm          , Hh          , Hh          , Hh          
Gg          , Gg          , Gs^Fp       , Gg          , Gs^Fp       , Gg^Vh       , Gs^Fp       , Gs^Fp       , Re          , Re          , Gg^Vh       , Gg          , Gs^Fp       , Gg          , Gg          , Hh          , Gs^Fp       , Mm          , Mm          , Mm          , Mm          , Mm          
Hh          , Hh          , Gs^Fp       , Gs^Fp       , Gs^Fp       , Gs^Fp       , Gg          , Gg          , Re          , Re          , Gs^Fp       , Gs^Fp       , Gg          , Gs^Fp       , Gs^Fp       , Hh          , Hh          , Mm          , Gs^Fp       , Hh          , Gs^Fp       , Gs^Fp       
Hh          , Hh          , Hh          , Gs^Fp       , Hh          , Hh          , Gg          , Re          , Gg          , Gs^Fp       , Gs^Fp       , Gs^Fp       , Gs^Fp       , Gs^Fp       , Gs^Fp       , Gs^Fp       , Gs^Fp       , Gs^Fp       , Gs^Fp       , Hh^Vhh      , Gs^Fp       , Gs^Fp       
Gs^Fp       , Gs^Fp       , Mm          , Hh          , Gs^Fp       , Gs^Fp       , Gg          , Re          , Re          , Re          , Re          , Gg          , Gs^Fp       , Gs^Fp       , Gg          , Hh^Vhh      , Gs^Fp       , Gs^Fp       , Gs^Fp       , Gs^Fp       , Gs^Fp       , Gs^Fp       
Gs^Fp       , Gs^Fp       , Hh^Vhh      , Mm          , Gs^Fp       , Gs^Fp       , Gg          , Gg          , Gg          , Re          , Gg          , Re          , Gg          , Gs^Fp       , Hh          , Hh          , Hh          , Gs^Fp       , Gs^Fp       , Gs^Fp       , Gs^Fp       , Gs^Fp       
Gs^Fp       , Gs^Fp       , Mm          , Mm          , Gg          , Gg          , Gs^Fp       , Gs^Fp       , Gs^Fp       , Gg          , Gg          , Re          , Re          , Gs^Fp       , Gs^Fp       , Hh          , Hh          , Gs^Fp       , Gs^Fp       , Gs^Fp       , Gs^Fp       , Gs^Fp       
Gs^Fp       , Gs^Fp       , Hh          , Hh          , Gs^Fp       , Gs^Fp       , Gs^Fp       , Gs^Fp       , Gs^Fp       , Gs^Fp       , Gg          , Gg          , Re          , Gg          , Gs^Fp       , Gs^Fp       , Gs^Fp       , Hh          , Hh          , Gs^Fp       , Gs^Fp       , Gs^Fp       
Gs^Fp       , Gs^Fp       , Gg          , Gs^Fp       , Gs^Fp       , Gs^Fp       , Gs^Fp       , Gs^Fp       , Gs^Fp       , Gg          , Gg          , Gg          , Re          , Gs^Fp       , Gs^Fp       , Gg^Ve       , Gs^Fp       , Gs^Fp       , Hh          , Gg          , Hh          , Hh          
Hh          , Hh          , Gg^Ve       , Gg          , Gs^Fp       , Gs^Fp       , Gg^Ve       , Gs^Fp       , Gg          , Gg          , Re          , Re          , Cv          , Gg          , Gs^Fp       , Gs^Fp       , Mm          , Mm          , Mm          , Hh          , Gs^Fp       , Gs^Fp       
Hh          , Hh          , Gs^Fp       , Hh          , Gg          , Gs^Fp       , Gs^Fp       , Gg          , Re          , Re          , Cv          , Cv          , Kv          , Gg          , Gs^Fp       , Hh          , Hh          , Mm          , Hh          , Gs^Fp       , Hh          , Hh          
Gs^Fp       , Gs^Fp       , Hh          , Hh          , Hh          , Gg          , Re          , Re          , Cv          , Re          , Gg          , Cv          , Gg          , Gg          , Hh          , Hh          , Mm          , Hh          , Hh^Vhh      , Gs^Fp       , Gs^Fp       , Gs^Fp       
Gg          , Gg^Vh       , Gs^Fp       , Hh          , Gg          , Gg          , Re          , Cv          , Gg^Ve       , Cv          , Gs^Fp       , Gg          , Hh          , Hh          , Gs^Fp       , Gs^Fp       , Gs^Fp       , Mm          , Mm          , Hh          , Gs^Fp       , Gs^Fp       
Hh          , Hh          , Gg          , Gg          , 1 Re        , Re          , Gs^Fp       , Gg          , Gs^Fp       , Gg          , Gs^Fp       , Gs^Fp       , Gs^Fp       , Gs^Fp       , Gg^Ve       , Gs^Fp       , Mm          , Gs^Fp       , Gs^Fp       , Gs^Fp       , Hh          , Hh          
Gg          , Gg          , Re          , Re          , Gs^Fp       , Gs^Fp       , Gs^Fp       , Gs^Fp       , Gs^Fp       , Gs^Fp       , Hh          , Hh          , Hh          , Hh          , Hh          , Mm          , Mm          , Mm          , Mm          , Gs^Fp       , Hh          , Hh          
Gg          , Gg          , Re          , Re          , Gs^Fp       , Gs^Fp       , Gs^Fp       , Gs^Fp       , Gs^Fp       , Gs^Fp       , Hh          , Hh          , Hh          , Hh          , Hh          , Mm          , Mm          , Mm          , Mm          , Gs^Fp       , Hh          , Hh          
