border_size=1
usage=map

Aa^Fpa      , Aa^Fpa      , Aa^Fpa      , Gs^Fp       , Aa^Fpa      , Gs^Fp       , Aa          , Aa          , Gs^Fp       , Gs^Fp       , Aa          , Aa          , Gs^Fp       , Aa^Fpa      , Aa^Fpa      , Gs^Fp       , Aa^Fpa      , Aa^Fpa      , Aa^Fpa      , Gs^Fp       , Gs^Fp       , Gs^Fp       , Gs^Fp       , Gs^Fp       , Aa^Fpa      , Aa^Fpa      , Gs^Fp       , Gs^Fp       , Gs^Fp       , Gg          
Gs^Fp       , Aa^Fpa      , Gg          , Gs^Fp       , Gs^Fp       , Gs^Fp       , Aa          , Gs^Fp       , Gg          , Hh          , Gs^Fp       , Aa          , Gs^Fp       , Aa^Fpa      , Gs^Fp       , Gs^Fp       , Gs^Fp       , Gs^Fp       , Gs^Fp       , Gs^Fp       , Gs^Fp       , Gs^Fp       , Gs^Fp       , Gs^Fp       , Gs^Fp       , Gs^Fp       , Gs^Fp       , Gs^Fp       , Aa^Fpa      , Gg          
Aa^Fpa      , Ggf         , Gs^Fp       , Gg          , Gs^Fp       , Aa^Fpa      , Aa^Fpa      , Hh          , Hh          , Hh          , Gs^Fp       , Gg          , Gs^Fp       , Gs^Fp       , Hh          , Hh          , Gs^Fp       , Aa          , Gg^Ve       , Gg          , Gs^Fp       , Aa          , Ce          , Ce          , Ce          , Gs^Fp       , Gg          , Gs^Fp       , Gs^Fp       , Gg          
Gs^Fp       , Aa          , Aa^Fpa      , Gg^Ve       , Gs^Fp       , Aa^Fpa      , Ggf         , Ggf         , Gg          , Gs^Fp       , Gs^Fp       , Gg^Ve       , Gs^Fp       , Gs^Fp       , Aa^Fpa      , Gs^Fp       , Gs^Fp       , Aa          , Gs^Fp       , Gs^Fp       , Gs^Fp       , Gs^Fp       , Gg          , 1 Ke        , Gs^Fp       , Gs^Fp       , Ggf         , Gs^Fp       , Gs^Fp       , Gs^Fp       
Gs^Fp       , Gg          , Aa^Fpa      , Gg          , Aa^Fpa      , Gs^Fp       , Gs^Fp       , Gs^Fp       , Aa^Fpa      , Aa^Fpa      , Aa          , Aa          , Gs^Fp       , Aa^Fpa      , Aa^Fpa      , Gs^Fp       , Gs^Fp       , Ggf         , Ggf         , Gg          , Gg^Ve       , Gs^Fp       , Gs^Fp       , Ce          , Gs^Fp       , Gs^Fp       , Gs^Fp       , Ggf         , Gs^Fp       , Gs^Fp       
Gs^Fp       , Gs^Fp       , Gs^Fp       , Gs^Fp       , Aa^Fpa      , Aa^Fpa      , Ggf         , Gs^Fp       , Gg          , Aa^Fpa      , Gs^Fp       , Aa          , Gs^Fp       , Gs^Fp       , Gs^Fp       , Gs^Fp       , Gs^Fp       , Ggf         , Gs^Fp       , Gs^Fp       , Gs^Fp       , Gs^Fp       , Gs^Fp       , Ggf         , Gg          , Gs^Fp       , Ggf         , Gs^Fp       , Gs^Fp       , Gs^Fp       
Aa^Fpa      , Gs^Fp       , Ggf         , Gs^Fp       , Gg          , Gs^Fp       , Gs^Fp       , Gs^Fp       , Gs^Fp       , Gg          , Gg          , Gs^Fp       , Gs^Fp       , Gs^Fp       , Gs^Fp       , Hh          , Hh          , Hh          , Gs^Fp       , Gs^Fp       , Gs^Fp       , Gs^Fp       , Ggf         , Gs^Fp       , Gs^Fp       , Gs^Fp       , Gs^Fp       , Ggf         , Gs^Fp       , Gg          
Aa^Fpa      , Aa          , Gs^Fp       , Ggf         , Gs^Fp       , Gs^Fp       , Gg          , Gg^Ve       , Gg          , Gs^Fp       , Gs^Fp       , Gs^Fp       , Ggf         , Gg          , Gs^Fp       , Hh          , Gg          , Aa          , Gs^Fp       , Gg          , Gs^Fp       , Ggf         , Gg          , Gs^Fp       , Gs^Fp       , Gg^Ve       , Gg          , Ggf         , Gs^Fp       , Gg          
Gs^Fp       , Gs^Fp       , Gs^Fp       , Gs^Fp       , Aa          , Aa          , Gs^Fp       , Gs^Fp       , Gs^Fp       , Gg          , Hh          , Hh          , Ggf         , Gg          , Gs^Fp       , Gs^Fp       , Gs^Fp       , Gs^Fp       , Gs^Fp       , Gs^Fp       , Gs^Fp       , Gs^Fp       , Gs^Fp       , Gs^Fp       , Gs^Fp       , Ggf         , Ggf         , Ggf         , Gs^Fp       , Gg          
Gs^Fp       , Aa          , Ggf         , Gs^Fp       , Gs^Fp       , Gs^Fp       , Ggf         , Ggf         , Gs^Fp       , Gg          , Hh          , Ggf         , Gs^Fp       , Gs^Fp       , Gs^Fp       , Gg^Ve       , Gs^Fp       , Gs^Fp       , Hh          , Hh          , Gs^Fp       , Gs^Fp       , Gg          , Gs^Fp       , Gs^Fp       , Gs^Fp       , Ggf         , Gg          , Gs^Fp       , Gs^Fp       
Gs^Fp       , Gs^Fp       , Gs^Fp       , Gg^Ve       , Gs^Fp       , Gs^Fp       , Ggf         , Ggf         , Gs^Fp       , Gs^Fp       , Gg          , Gg          , Gs^Fp       , Gs^Fp       , Gs^Fp       , Gs^Fp       , Gg          , Gg          , Hh          , Hh          , Gs^Fp       , Gg          , Gs^Fp       , Gs^Fp       , Gg          , Gg          , Hh          , Gg          , Gs^Fp       , Gg          
Aa^Fpa      , Aa^Fpa      , Aa^Fpa      , Gs^Fp       , Gs^Fp       , Aa          , Gg          , Hh          , Hh          , Gs^Fp       , Gg          , Gs^Fp       , Gs^Fp       , Gs^Fp       , Gs^Fp       , Gs^Fp       , Gs^Fp       , Hh          , Gs^Fp       , Ggf         , Ggf         , Gg          , Gg^Ve       , Gg          , Gg          , Hh          , Hh          , Gs^Fp       , Gs^Fp       , Gs^Fp       
Aa^Fpa      , Aa^Fpa      , Aa^Fpa      , Gs^Fp       , Gs^Fp       , Gs^Fp       , Gs^Fp       , Gg          , Hh          , Hh          , Gg          , Gs^Fp       , Gs^Fp       , Gs^Fp       , Gs^Fp       , Gs^Fp       , Gs^Fp       , Gs^Fp       , Gs^Fp       , Ggf         , Gg          , Gg          , Gg          , Gg          , Hh          , Hh          , Gg          , Gs^Fp       , Gg          , Gs^Fp       
Aa^Fpa      , Aa^Fpa      , Gs^Fp       , Gs^Fp       , Gg          , Gs^Fp       , Gs^Fp       , Gs^Fp       , Gs^Fp       , Hh          , Gg          , Gs^Fp       , Gs^Fp       , Gs^Fp       , Gs^Fp       , Gg          , Gs^Fp       , Gg          , Gg          , Gs^Fp       , Gs^Fp       , Gs^Fp       , Ggf         , Gg          , Gg          , Hh          , Gs^Fp       , Gg          , Gs^Fp       , Gg          
Gs^Fp       , Gs^Fp       , Hh          , Hh          , Hh          , Gg          , Gg          , Gs^Fp       , Gg^Ve       , Gs^Fp       , Gg          , Gg          , Gs^Fp       , Gg          , Gs^Fp       , Gs^Fp       , Gs^Fp       , Gg^Ve       , Gg          , Gg          , Gg          , Gg          , Ggf         , Gs^Fp       , Gs^Fp       , Gs^Fp       , Gs^Fp       , Gs^Fp       , Ggf         , Gg          
Gs^Fp       , Gs^Fp       , Hh          , Hh          , Hh          , Gs^Fp       , Gs^Fp       , Gs^Fp       , Gs^Fp       , Gs^Fp       , Gs^Fp       , Gs^Fp       , Gs^Fp       , Gg          , Gs^Fp       , Gg          , Gs^Fp       , Gg          , Gs^Fp       , Gs^Fp       , Gg          , Ggf         , Ggf         , Gs^Fp       , Gg          , Gs^Fp       , Gs^Fp       , Ggf         , Gg          , Gg          
Gs^Fp       , Hh          , Gs^Fp       , Gs^Fp       , Gs^Fp       , Gg          , Gg          , Gg          , Ggf         , Ggf         , Gg          , Gs^Fp       , Gg          , Gg          , Gg          , Gg          , Gg          , Gg          , Gg          , Gg          , Gg          , Gg          , Gg          , Gs^Fp       , Gs^Fp       , Gs^Fp       , Gg          , Ggf         , Gg          , Gg          
Gs^Fp       , Gs^Fp       , Gg          , Gs^Fp       , Gg          , Gg          , Gg          , Gs^Fp       , Gs^Fp       , Ggf         , Ggf         , Gg          , Gg          , Gg          , Hh          , Hh          , Gg          , Gg          , Gg          , Gs^Fp       , Gg          , Gg          , Gg          , Gs^Fp       , Gs^Fp       , Gg          , Gg          , Gg          , Gg          , Gg          
Gs^Fp       , Gg          , Gs^Fp       , Gg^Ve       , Gg          , Hh          , Gg          , Gg          , Gg          , Gg          , Gg          , Ggf         , Gg          , Hh          , Gg          , Gg          , Gg          , Gg          , Gg          , Gg          , Gg          , Gg          , Gg          , Gg          , Gg          , Gg          , Hh^Vhh      , Gg          , Gg          , Gg          
Gs^Fp       , Gs^Fp       , Gs^Fp       , Gs^Fp       , Gg          , Hh          , Gg          , Gs^Fp       , Gg          , Gg          , Gg          , Hh^Vhh      , Hh          , Gg          , Gg          , Gg          , Gg^Vh       , Gs^Fp       , Gs^Fp       , Gg          , Gg          , Gg          , Gg          , Gg          , Gg          , Gg          , Gg          , Gg          , Gg          , Gg          
Gs^Fp       , Gs^Fp       , Gs^Fp       , Gg          , Gg          , Gg          , Gg          , Gg          , Gg          , Gg          , Gg          , Hh          , Hh          , Gg          , Gg          , Gg          , Gg          , Gg          , Gg          , Gg          , Gg          , Gg          , Gg          , Gg          , Gg          , Gg          , Gg          , Gg          , Gg          , Gg          
Gs^Fp       , Gs^Fp       , Gs^Fp       , Gs^Fp       , Gs^Fp       , Gs^Fp       , Gs^Fp       , Gs^Fp       , Gs^Fp       , Gg          , Gg          , Gg          , Gg          , Gg          , Gg          , Gg          , Gg          , Gg          , Gg          , Gg          , Gg          , Gg          , Gg          , Gg          , Gg          , Gg          , Gg          , Gg          , Gg          , Gg          
Gs^Fp       , Gs^Fp       , Gg          , Gs^Fp       , Gs^Fp       , Gg          , Gs^Fp       , Gs^Fp       , Gg          , Gg          , Gg          , Gg          , Gg^Vh       , Gg          , Gg          , Gg          , Gg          , Gg          , Gg          , Gg          , 3 Kh        , Chr         , Gg          , Gg          , Gg          , Gg          , Gg          , Gg          , Ww          , Gg          
Gs^Fp       , Gg          , Gg          , Gg          , Gg          , Gs^Fp       , Gg          , Gg          , Gg          , Gg          , Gg          , Gg          , Gg          , Gg          , Gg          , Gg          , Ww          , Ww          , Ww          , Chw         , Ww          , Chw         , Ww^Bw|      , Gg^Vh       , Ww          , Ww          , Ww          , Ww          , Ww          , Ww          
Gs^Fp       , Gg          , Gs^Fp       , Gg          , Gg          , Gs^Fp       , Gg          , Gg          , Gg          , Gg          , Gg          , Gg          , Gg          , Gg          , Ww          , Ww          , Ww          , Ww          , Wo          , Ww          , Wo          , Wo          , Ww          , Ww          , Ww          , Ww          , Wo          , Ww          , Wo          , Wo          
Gs^Fp       , Hh          , Gs^Fp       , Gg^Ve       , Gg          , Gg          , Gg          , Gg          , Gg          , Gg          , Ww          , Gg          , Ww          , Ww          , Wo          , Wo          , Ww          , Wo          , Chw         , Wo          , Ww          , Wo          , Ww          , Wo          , Ww          , Wo          , Ww          , Wo          , Ww          , Wo          
Gs^Fp       , Hh          , Hh          , Gg          , Gg          , Gg          , Ww          , Gg          , Ww          , Ww          , Wo          , Ww          , Wo          , Wo          , Ww          , Ww          , Gg          , Chr         , 4 Kh        , Chw         , Ww          , Ww          , Ww^Bw|      , Wo          , Gg          , Ww          , Ww          , Ww          , Ww          , Ww          
Gs^Fp       , Hh          , Hh          , Hh          , Gg          , Gg          , Ww^Bw\      , Ww          , Wo          , Ww          , Wo          , Wo          , Ww          , Ww          , Gg          , Gg^Vh       , Gg          , Chr         , Gg          , Ww          , Ww          , Gg          , Gg          , Gg          , Gg          , Gg          , Gg          , Gg          , Gg          , Gg          
Hh          , Hh          , Gg          , Gg          , Ww          , Ww          , Wo          , Ww          , Ww          , Wo          , Ww          , Ww          , Ww          , Ww          , Gg          , Gg          , Gg          , Gg          , Gg          , Ww          , Ww          , Gg          , Gg          , Gg          , Gg          , Gg          , Gg          , Hh          , Hh          , Gg          
Gg          , Gg          , Ww          , Ww          , Ww          , Ww          , Wo          , Wo          , Ww          , Ww^Bw\      , Gg          , Gg          , Gg          , Gg          , Gg          , Gg          , Gg          , Gg          , Gg          , Gg          , Gg          , Ww^Bw/      , Ww          , Gg          , Gg          , Gg^Vh       , Gg          , Gg          , Hh          , Gg          
Ww          , Ww          , Ww          , Wo          , Ww          , Wo          , Ww          , Ww          , Gg          , Gg^Vh       , Gg          , Gg          , Gg          , Gg          , Gg          , Gg          , Ke          , Gg          , Re          , Gg          , Gg          , Gg          , Ww          , Gg          , Gg          , Gg          , Gg          , Gg          , Gg          , Gg          
Ww          , Ww          , Ww          , Ww          , Gg          , Ww          , Gg          , Gg          , Gg          , Gg          , Gg          , Gg          , Gg          , Gg          , Ce          , Ce          , Re          , Ce          , Re          , Ce          , Re          , Gg          , Gg          , Ww          , Ww          , Gg          , Gg          , Gg          , Gg^Vh       , Gg          
Ww          , Ww          , Gg          , Gg          , Gg          , Gg          , Hh          , Hh          , Gg          , Gg          , Ce          , Ce          , Ce          , Re          , Re          , Re          , Re          , Re          , Re          , Re          , Re          , Ce          , Ke          , Gg          , Gg          , Ww          , Ww          , Gg          , Gg          , Gg          
Gg          , Gg          , Gg          , Gg          , Gg          , Hh          , Gg          , Gg          , Gg          , Ke          , Re          , Re          , Re          , Re          , Re          , Re          , Re          , Re          , Re          , Re          , Re          , Re          , Re          , Ce          , Re          , Hh          , Ww          , Gg          , Gg          , Gg          
Hh          , Hh          , Hh          , Hh          , Hh          , Gg          , Gg^Vh       , Gg          , Gg          , Ce          , Re          , Re          , Re          , Re          , Re          , Re          , Re          , Re          , Re          , Re          , Re          , Re          , Re          , Re          , Ce          , Hh          , Ww          , Gg          , Gg          , Gg          
Mm          , Hh          , Mm          , Hh          , Hh          , Gg          , Gg          , Gg          , Gg          , Re          , Re          , Re          , Re          , Re          , Ce          , Ce          , 2 Ke        , Ce          , Ce          , Re          , Re          , Re          , Re          , Re          , Re          , Ke          , Ww          , Gg          , Gg          , Gg          
Mm          , Mm          , Mm          , Mm          , Gg          , Gg          , Gg          , Gg          , Ke          , Ce          , Re          , Re          , Re          , Re          , Re          , Gg^Ve       , Gg^Ve       , Gg^Ve       , Re          , Re          , Re          , Re          , Re          , Re          , Re          , Ce          , Ww          , Ww          , Gg          , Gg          
Mm          , Mm          , Hh          , Hh          , Gg          , Gg          , Gg          , Ce          , Re          , Re          , Re          , Re          , Re          , Re          , Re          , Re          , Re          , Re          , Re          , Re          , Re          , Re          , Re          , Re          , Re          , Re          , Ww          , Ww          , Gg          , Gg          
